###########################/
###########################/
###########################/
###########################/
###########################/
#########vvvvvvvv==vvvvv###/
#####vvvv~~~~~~~~==~~~~~vvv/
vvvvv~~~~~~~~~~~~==~~~~~~~~/
~~~~~~~~~~~~~~~~~==~~~~~~~~/
~~~~~~~~~~~~~~vvv==vvv~~~~~/
~~~~~~~~~vvvvv########vvvvv/
vvvvvvvvv##################/
###########################/
###########################/
###########################/
###########################/
